{
    "compose_ids": [
        134257216, 
        134268943, 
        134233952, 
        134244701, 
        134280428, 
        201390095, 
        201390094, 
        201390093, 
        201390091, 
        201390090, 
        201390089, 
        201390087, 
        201390088, 
        201390085, 
        201390086, 
        201390081, 
        201390082, 
        134245059, 
        134238903, 
        201390083, 
        201390084, 
        201390096, 
        201390097, 
        134278589, 
        134257065, 
        134264126, 
        134253385, 
        134243995, 
        134267045, 
        134275213, 
        134278629, 
        134280087, 
        134218218, 
        134262923, 
        134262215, 
        134233763, 
        134255180, 
        134224775, 
        134218624, 
        134221867, 
        134240232, 
        134257384, 
        134234796, 
        134229235, 
        134253920, 
        134275099, 
        134273700, 
        201390092, 
        134258256, 
        134276637, 
        134269247, 
        134250786, 
        134257230, 
        134250168, 
        134233693, 
        134277246, 
        201390023, 
        201390024, 
        201390001, 
        201390002, 
        134245520, 
        134253209, 
        134266379, 
        134240669, 
        134280991, 
        134275957, 
        134230837, 
        134236007, 
        134223047, 
        134225554, 
        134234372, 
        134232731, 
        134234184, 
        134233714, 
        134245241, 
        134261625, 
        134249344, 
        134223669, 
        134274297, 
        134248551, 
        134276664, 
        134259689, 
        134226793, 
        134265097, 
        134247817, 
        134233791, 
        134271464, 
        134255423, 
        134218947, 
        134228013, 
        134227812, 
        134272155, 
        134227995, 
        134259307, 
        134232184, 
        134231248, 
        134220541, 
        134268307, 
        134240535, 
        134277855, 
        134237505, 
        134264424, 
        134268302, 
        134254971, 
        134273957, 
        134263108, 
        134274011, 
        134228965, 
        134260051, 
        134232942, 
        134218255, 
        134229901, 
        134280953, 
        134261958, 
        134230576, 
        134241101, 
        134245300, 
        134258923, 
        134279326, 
        134256411, 
        134273910, 
        134259605, 
        134271998, 
        134252824, 
        134270969, 
        134227391, 
        134275375, 
        134280944, 
        134271188, 
        134262894, 
        134268330, 
        134218396, 
        134242241, 
        134243243, 
        134259428, 
        134267950, 
        134227762, 
        134251511, 
        134267145, 
        134282377, 
        134261948, 
        134250353, 
        134244580, 
        134255709, 
        134266191, 
        134248312, 
        134230474, 
        134263710, 
        134235310, 
        134236738, 
        134246604, 
        134238252, 
        134229861, 
        134250639, 
        134265640, 
        134242321, 
        134246379, 
        134247346, 
        134227065, 
        134243679, 
        134218264, 
        134251578, 
        134227887, 
        134246778, 
        134229605, 
        134257589, 
        134268378, 
        134244539, 
        134271557, 
        134220479, 
        134259069, 
        134239750, 
        134257634, 
        134226523, 
        134233480, 
        134262606, 
        134224608, 
        134268038, 
        134251460, 
        134274367, 
        134268857, 
        134234036, 
        134262788, 
        134222711, 
        134262870, 
        134276730, 
        134230060, 
        134231969, 
        134273787, 
        134233192, 
        134230958, 
        134276336, 
        134275958, 
        134227759, 
        134270425, 
        134260701, 
        134261747, 
        134274006, 
        134224659, 
        134228737, 
        134281904, 
        134260145, 
        134250175, 
        134226133, 
        134257317, 
        134259371, 
        134272282, 
        134224017, 
        134261341, 
        134270015, 
        134226664, 
        134279090, 
        134226207, 
        134260457, 
        134248171, 
        134227199, 
        134256406, 
        134238658, 
        134266319, 
        134244655, 
        134277465, 
        134279958, 
        134226851, 
        134234362, 
        134222091, 
        134245234, 
        134253271, 
        134259979, 
        134282312, 
        134256002, 
        134255875, 
        134222731, 
        134219242, 
        134263842, 
        134245009, 
        134225279, 
        134279088, 
        134258005, 
        134270549, 
        134219292, 
        134246330, 
        134218067, 
        134223709, 
        134229643, 
        134271721, 
        134272691, 
        134218195, 
        134250068, 
        134247618, 
        134277385, 
        134236513, 
        134260740, 
        134245845, 
        134223018, 
        134265445, 
        134243912, 
        134252883, 
        134221467
    ], 
    "item_id_seed": 0
}