{
    "ability_all": [
        "\u51b2\u523a", 
        "\u7f81\u7eca\u52a0\u6210", 
        "\u6b66\u529f", 
        "\u5916\u529f", 
        "\u5927\u7406", 
        "\u5438\u8840\u53cd\u4f24", 
        "\u900d\u9065", 
        "\u5173\u5916", 
        "\u5200\u6cd5", 
        "\u5f13\u7bad", 
        "\u6b66\u5f53", 
        "\u4f20\u5947", 
        "\u5251\u6cd5", 
        "\u4e10\u5e2e", 
        "\u62f3\u638c", 
        "\u5f02\u672f", 
        "\u6843\u82b1", 
        "\u6697\u5668", 
        "\u9634\u5bd2", 
        "\u97ad\u6cd5", 
        "\u5c11\u6797", 
        "\u56de\u590d", 
        "\u6c5f\u6e56", 
        "\u53e4\u5893", 
        "\u897f\u57df", 
        "\u5927\u62db", 
        "\u63a8\u8350\u6807\u7b7e_\u5f02\u672f"
    ], 
    "editor_item": [
        "\u6d88\u8017\u54c1", 
        "\u88ab\u52a8\u4f7f\u7528", 
        "\u9632\u5fa1", 
        "\u6c14\u8840", 
        "\u56de\u8840", 
        "\u62a4\u7532", 
        "\u6cd5\u6297", 
        "\u51b7\u5374"
    ], 
    "editor_unit": [
        "\u6218\u58eb", 
        "\u6cd5\u5e08", 
        "\u8fd1\u6218", 
        "\u7269\u6cd5\u53cc\u4fee", 
        "\u7fa4\u63a7", 
        "\u4e0a\u8def\u53d1\u80b2", 
        "\u91ce\u533a\u53d1\u80b2", 
        "\u8fdc\u7a0b", 
        "\u7206\u53d1", 
        "\u4e2d\u8def\u53d1\u80b2", 
        "soldiers", 
        "\u6c34\u6676", 
        "\u9632\u5b88\u6a21\u5f0f\u53cb\u65b9\u5355\u4f4d", 
        "\u5c0f\u602a", 
        "\u673a\u5173\u4eba", 
        "\u53ec\u5524\u7269"
    ]
}